ZZZZZZZZZZZZZZZZZZZZ
ZNNRRNRRNNNNNNNNNNNZ
ZNRRNRNNRNRNNRNRNNNZ
ZNNNNNNNNNNNNNRRNNNZ
ZNNNNEEEEEENNNRNNNNZ
ZNNNNEEEEEENNNNNNNNZ
ZNNNNEEEENNNNNNNENNZ
ZNNNNEENNNNNNEEEENNZ
ZNNNNENNNNNRNEEEENNZ
ZNNNNNNNNNNNNNNEENNZ
ZNNNNNRNNNNNNNNNENNZ
ZNNNNRRNNNNNRNNNNNNZ
ZNNNNNRNNNNNNNNNNNNZ
ZNNNEEEENNNNNNRRNNNZ
ZNNNEEENNNNNNNRRRRNZ
ZNNNENNNNRNRNNNNNNNZ
ZNNNNRNNNNNNNNNNNNNZ
ZNNNRNNNNRRNNNNRNNNZ
ZNNRNNNNNNNNRNNNNNNZ
ZZZZZZZZZZZZZZZZZZZZ